1111111111111111
1**************1
1*e*****e******1
1**2*******2***1
1**e*2*p*******1
1**************1
1**1*2*e*******1
1**********1***1
1*e************1
1********e****e1
1*1***2********1
1**************1
1**e***********1
1***2*****e2***1
1***e**********1
1111111111111111
