1111111111111111
1**************1
1***22******2**1
1**************1
1********22****1
1**************1
1**********2***1
1**22**********1
1**************1
1*******2******1
1**************1
1*22********2**1
1**************1
1******22******12
1**************1
1111111111111111
