1111111111111111
1**************1
1**************1
1**************1
1**2**2**2e*2**1
1**************1
1**2*e2**2*e2**1
1**************1
1*e*****p******1
1**************1
1**2**2**2**2**1
1**************1
1**2**2**2**2**1
1**************1
1**************1
1111111111111111
